11111111111111111
10P000X0000C00E11
11111111111111111
