1111111111111111111111111111111111111111111111111
1P0000000000000000X000000000000000000000000000001
1001111111111111111111111111111111111111111111111
1000000000000000000000000000000000000000000000001
1111111111111111111111111101111111111111111111111
1C0000C0000X000000000000000000000000000C000000001
10000C000C00000C000000000000C0X0000X00X0000C00001
1000X000C000C0C000000C0000C00000000000C0000000001
1111111111111111111XX11111111XX111111111111101111
1XCCCXCXCCCCCCC00000C0000C00000C0000C00000C00C001
1CCXCCCCCXCCX0C0X0000X000X000X0C00X000XC000X00001
1111111111111111111111111111111111110111111111111
10000X000X00X00C0000000X0000X0C000000000000C00001
1000000C0X00000X000C000X00C0000X000X0C000XX000001
1C000X000C00C000000X000C00000000C0000000000000001
1111111111111111111111XX1111111111110111111111111
1000X0000000C0000C000000X000000C00000000000000001
10000X00X0000X00000000000000000000000000000000001
1CC00000X00X00C0000C00000X0000000X000000000000001
1EC00000000000000C00000000000X0000000000000000001
1111111111111111111111111111111111111111111111111